class Maze
  def __init__(self)
    self.M = 20
    self.N = 9
    self.maze = [  1,1,1,1,1,1,1,1,1,1,1,1,1,1,1,1,1,1.1.1,
                   1,0,0,0,0,0,0,0,0,0,0,0,0,0,0,0,0,0,0,1,
                   1,0,1,1,1,1,1,1,1,1,1,0,0,1,1,1,1,1,0,1,
                   1,0,1,1,1,1,1,1,1,1,1,0,1,1,1,1,1,1,0,1,
                   1,0,0,0,0,0,0,0,0,0,0,1,0,0,0,0,0,0,0,1,
                   1,0,0,0,0,0,0,0,0,0,0,1,1,1,1,1,1,1,0,1,
                   1,1,1,1,1,1,1,1,1,1,1,1,1,1,1,1,1,1,1,1,
                   0,0,0,0,0,0,0,0,0,0,0,0,0,0,0,0,0,0,0,0,
                   1,1,1,1,1,1,1,1,1,1,1,1,1,1,1,1,1,1,1,1, ]
                   
